11111111111111111111
10010011110000000011
10111000000110101011
10000010110101010101
10101110110000000001
10100010111111111111
10101010000000000001
10111011111000010001
10101011000111110001
1ECP0011000000000001
11111111111111111111