111111111111111111111111111111111111111111111111111
111111110000000000011111111111000000000000111111111
111111000000001111100000111000000111110000000111111
111100000001111111111111000111111111111110000011111
111000000011111111111111101111111111111111100001111
110000001111111111111111111111111111111111110000111
110000011111111111111111111111111111111111111000011
100000111111111111111111101111111111111111110000011
100000111111111111111111CPE111111111111111000000111
110000001111111111111111101111111111111110000000111
111000000011111111111111111111111111111100000001111
111110000001111111111111111111111111111000000111111
111111100000011111111111111111111111100000011111111
111111111100000111111111111111111111000011111111111
111111111111100001111111111111111100001111111111111
111111111111111000011111111111110001111111111111111
111111111111111110001111111110001111111111111111111
111111111111111111100011111001111111111111111111111
111111111111111111111100110011111111111111111111111
111111111111111111111111001111111111111111111111111
111111111111111111111111111111111111111111111111111