1111111111111111111111111111111111111111
11CCCCCCCCCCCCCCCCCCCCCCCCCCCCCCCCCCCCC1
11CCCCCCCCC1111111CCCCCCCCCCCCCCCCCCCCC1
11CCCCCCCC1CCCCCCC11111111111111111111C1
11C1111111CPC1C1CC111CCCCCCCCCCCCCCC11C1
11CCCCCCCCCCCCCCCCCCCCCCCCCCCCCCCCCCCCC1
11CCCCCCCCCCCCCCCCCCCCCCCCCCCCCCCCCCCCC1
11CCCCCCCCCCCCCCCCCCCCCCCCCCCCCCCCCCCCC1
11CCCCCCCCCCCCCCCCCCCCCCCCCCCCCCCCCCCCC1
11CCCCCCCCCCCCCCCCCCCCCCCCCCCCCCCCCCCCC1
11CCCCCCCCCCCCCCCCCCCCCCCCCCCCCCCCCCCCC1
11CCCCCCCCCCCCCCCCCCCCCCCCCCCCCCCCCCCCC1
11CCCCCCCCCCCCCCCCCCCCCCCCCCCCCCCCCCCCC1
11CCCCCCCCCCCCCCCCCCCCCCCCCCCCCCCCCCCCC1
11CCCCCCCCCCCCCCCCCCCCCCCCCCCCCCCCCCCCC1
11CCCCCCCCCCCCCCCCCCCCCCCCCCCCCCCCCCCCC1
11CCCCCCCCCCCCCCCCCCCCCCCCCCCCCCCCCCCCC1
11CCCCCCCCCCCCCCCCCCCCCCCCCCCCCCCCCCCCC1
11CCCCCCCCCCCCCCCCCCCCCCCCCCCCCCCCCCCCC1
11CCCCCCCCCCCCCCCCCCCCCCCCCCCCCCCCCCCCC1
11CCCCCCCCCCCCCCCCCCCCCCCCCCCCCCCCCCCCC1
11CCCCCCCCCCCCCCCCCCCCCCCCCCCCCCCCCCCCC1
11CCCCCCCCCCCCCCCCCCCCCCCCCCCCCCCCCCCCC1
11CCCCCCCCCCCCCCCCCCCCCCCCCCCCCCCCCCCCC1
11CCCCCCCCCCCCCCCCCCCCCCCCCCCCCCCCCCCCC1
11CCCCCCCCCCCCCCCCCCCCCCCCCCCCCCCCCCCCC1
11CCCCCCCCCCCCCCCCCCCCCCCCCCCCCCCCCCCCC1
11CCCCCCCCCCCCCCCCCCCCCCCCCCCCCCCCCCCCC1
11CCCCCCCCCCCCCCCCCCCCCCCCCCCCCCCCCCCCC1
11CCCCCCCCCCCCCCCCCCCCCCCCCCCCCCCCCCCCC1
11CCCCCCCCCCCCCCCCCCCCCCCCCCCCCCCCCCCCC1
11CCCCCCCCCCCCCCCCCCCCCCCCCCCCCCCCCCCCC1
11CCCCCCCCCCCCCCCCCCCCCCCCCCCCCCCCCCCCC1
11CCCCCCCCCCCCCCCCCCCCCCCCCCCCCCCCCCCCC1
11CCCCCCCCCCCCCCCCCCCCCCCCCCCCCCCCCCCCC1
11CCCCCCCCCCCCCCCCCCCCCCCCCCCCCCCCCCCCC1
11CCCCCCCCCCCCCCCCCCCCCCCCCCCCCCCCCCCCC1
11CCCCCCCCCCCCCCCCCCCCCCCCCCCCCCCCCCCCC1
11CCCCCCCCCCCCCCCCCCCCCCCCCCCCCCCCCCCCC1
11CCCCCCCCCCCCCCCCCCCCCCCCCCCCCCCCCCCCC1
11CCCCCCCCCCCCCCCCCCCCCCCCCCCCCCCCCCCCC1
11CCCCCCCCCCCCCCCCCCCCCCCCCCCCCCCCCCCCC1
11CCCCCCCCCCCCCCCCCCCCCCCCCCCCCCCCCCCCC1
11CCCCCCCCCCCCCCCCCCCCCCCCCCCCCCCCCCCCC1
11CCCCCCCCCCCCCCCCCCCCCCCCCCCCCCCCCCCCC1
11CCCCCCCCCCCCCCCCCCCCCCCCCCCCCCCCCCCCC1
11CCCCCCCCCCCCCCCCCCCCCCCCCCCCCCCCCCCCC1
11CCCCCCCCCCCCCCCCCCCCCCCCCCCCCCCCCCCCC1
11CCCCCCCCCCCCCCCCCCCCCCCCCCCCCCCCCCCCC1
11CCCCCCCCCCCCCCCCCCCCCCCCCCCCCCCCCCCCC1
11CCCCCCCCCCCCCCCCCCCCCCCCCCCCCCCCCCCCC1
11CCCCCCCCCCCCCCCCCCCCCCCCCCCCCCCCCCCCC1
11CCCCCCCCCCCCCCCCCCCCCCCCCCCCCCCCCCCCC1
11CCCCCCCCCCCCCCCCCCCCCCCCCCCCCCCCCCCCC1
11CCCCCCCCCCCCCCCCCCCCCCCCCCCCCCCCCCCCC1
11CCCCCCCCCCCCCCCCCCCCCCCCCCCCCCCCCCCCC1
11CCCCCCCCCCCCCCCCCCCCCCCCCCCCCCCCCCCCC1
11CCCCCCCCCCCCCCCCCCCCCCCCCCCCCCCCCCCCC1
11CCCCCCCCCCCCCCCCCCCCCCCCCCCCCCCCCCCCC1
11CCCCCCCCCCCCCCCCCCCCCCCCCCCCCCCCCCCCC1
11CCCCCCCCCCCCCCCCCCCCCCCCCCCCCCCCCCCCC1
11CCCCCCCCCCCCCCCCCCCCCCCCCCCCCCCCCCCCC1
11CCCCCCCCCCCCCCCCCCCCCCCCCCCCCCCCCCCCC1
11CCCCCCCCCCCCCCCCCCCCCCCCCCCCCCCCCCCCC1
11CCCCCCCCCCCCCCCCCCCCCCCCCCCCCCCCCCCCC1
11CCCCCCCCCCCCCCCCCCCCCCCCCCCCCCCCCCCCC1
11CCCCCCCCCCCCCCCCCCCCCCCCCCCCCCCCCCCCC1
11CCCCCCCCCCCCCCCCCCCCCCCCCCCCCCCCCCCCC1
11CCCCCCCCCCCCCCCCCCCCCCCCCCCCCCCCCCCCC1
11CCCCCCCCCCCCCCCCCCCCCCCCCCCCCCCCCCCCC1
11CCCCCCCCCCCCCCCCCCCCCCCCCCCCCCCCCCCCC1
11CCCCCCCCCCCCCCCCCCCCCCCCCCCCCCCCCCCCC1
11CCCCCCCCCCCCCCCCCCCCCCCCCCCCCCCCCCCCC1
11CCCCCCCCCCCCCCCCCCCCCCCCCCCCCCCCCCCCC1
11CCCCCCCCCCCCCCCCCCCCCCCCCCCCCCCCCCCCC1
11CCCCCCCCCCCCCCCCCCCCCCCCCCCCCCCCCCCCC1
11CCCCCCCCCCCCCCCCCCCCCCCCCCCCCCCCCCCCC1
11CCCCCCCCCCCCCCCCCCCCCCCCCCCCCCCCCCCCC1
11CCCCCCCCCCCCCCCCCCCCCCCCCCCCCCCCCCCCC1
11CCCCCCCCCCCCCCCCCCCCCCCCCCCCCCCCCCCCC1
11CCCCCCCCCCCCCCCCCCCCCCCCCCCCCCCCCCCCC1
11CCCCCCCCCCCCCCCCCCCCCCCCCCCCCCCCCCCCC1
11CCCCCCCCCCCCCCCCCCCCCCCCCCCCCCCCCCCCC1
11CCCCCCCCCCCCCCCCCCCCCCCCCCCCCCCCCCCCC1
11CCCCCCCCCCCCCCCCCCCCCCCCCCCCCCCCCCCCC1
11CCCCCCCCCCCCCCCCCCCCCCCCCCCCCCCCCCCCC1
11CCCCCCCCCCCCCCCCCCCCCCCCCCCCCCCCCCCCC1
11CCCCCCCCCCCCCCCCCCCCCCCCCCCCCCCCCCCCC1
11CCCCCCCCCCCCCCCCCCCCCCCCCCCCCCCCCCCCC1
11CCCCCCCCCCCCCCCCCCCCCCCCCCCCCCCCCCCCC1
11CCCCCCCCCCCCCCCCCCCCCCCCCCCCCCCCCCCCC1
11CCCCCCCCCCCCCCCCCCCCCCCCCCCCCCCCCCCCC1
11CCCCCCCCCCCCCCCCCCCCCCCCCCCCCCCCCCCCC1
11CCCCCCCCCCCCCCCCCCCCCCCCCCCCCCCCCCCCC1
11CCCCCCCCCCCCCCCCCCCCCCCCCCCCCCCCCCCCC1
11CCCCCCCCCCCCCCCCCCCCCCCCCCCCCCCCCCCCC1
11CCCCCCCCCCCCCCCCCCCCCCCCCCCCCCCCCCCCC1
11CCCCCCCCCCCCCCCCCCCCCCCCCCCCCCCCCCCCC1
11CCCCCCCCCCCCCCCCCCCCCCCCCCCCCCCCCCCCC1
11CCCCCCCCCCCCCCCCCCCCCCCCCCCCCCCCCCCCC1
11CCCCCCCCCCCCCCCCCCCCCCCCCCCCCCCCCCCCC1
11CCCCCCCCCCCCCCCCCCCCCCCCCCCCCCCCCCCCC1
11CCCCCCCCCCCCCCCCCCCCCCCCCCCCCCCCCCCCC1
11CCCCCCCCCCCCCCCCCCCCCCCCCCCCCCCCCCCCC1
11CCCCCCCCCCCCCCCCCCCCCCCCCCCCCCCCCCCCC1
11CCCCCCCCCCCCCCCCCCCCCCCCCCCCCCCCCCCCC1
11CCCCCCCCCCCCCCCCCCCCCCCCCCCCCCCCCCCCC1
11CCCCCCCCCCCCCCCCCCCCCCCCCCCCCCCCCCCCC1
11CCCCCCCCCCCCCCCCCCCCCCCCCCCCCCCCCCCCC1
11CCCCCCCCCCCCCCCCCCCCCCCCCCCCCCCCCCCCC1
11CCCCCCCCCCCCCCCCCCCCCCCCCCCCCCCCCCCCC1
11CCCCCCCCCCCCCCCCCCCCCCCCCCCCCCCCCCCCC1
11CCCCCCCCCCCCCCCCCCCCCCCCCCCCCCCCCCCCC1
11CCCCCCCCCCCCCCCCCCCCCCCCCCCCCCCCCCCCC1
11CCCCCCCCCCCCCCCCCCCCCCCCCCCCCCCCCCCCC1
11CCCCCCCCCCCCCCCCCCCCCCCCCCCCCCCCCCCCC1
11CCCCCCCCCCCCCCCCCCCCCCCCCCCCCCCCCCCCC1
11CCCCCCCCCCCCCCCCCCCCCCCCCCCCCCCCCCCCC1
11CCCCCCCCCCCCCCCCCCCCCCCCCCCCCCCCCCCCC1
11CCCCCCCCCCCCCCCCCCCCCCCCCCCCCCCCCCCCC1
11CCCCCCCCCCCCCCCCCCCCCCCCCCCCCCCCCCCCC1
11CCCCCCCCCCCCCCCCCCCCCCCCCCCCCCCCCCCCC1
11CCCCCCCCCCCCCCCCCCCCCCCCCCCCCCCCCCCCC1
11CCCCCCCCCCCCCCCCCCCCCCCCCCCCCCCCCCCCC1
11CCCCCCCCCCCCCCCCCCCCCCCCCCCCCCCCCCCCC1
11CCCCCCCCCCCCCCCCCCCCCCCCCCCCCCCCCCCCC1
11CCCCCCCCCCCCCCCCCCCCCCCCCCCCCCCCCCCCC1
11CCCCCCCCCCCCCCCCCCCCCCCCCCCCCCCCCCCCC1
111111111E11111CCC111C11111C1111111C11C1
11CCCCC111111CCCC1111CCCCCCCCCCCCCCC11C1
11CCCCC1CC1CCC1111111CCCCCCCCCCCCCCC11C1
11CCCCCC1C11111111111CCCCCCCCCCCCCCC11C1
11CCCCCCCCCCCCCCCCCCCCCCCCCCCCCCCCCCCCC1
1111111111111111111111111111111111111111
