11111111111
10010001001
1C1000P1001
1C1P1110001
11111111111