11111111

10000001
1000CPE1
11111101
11111111