1111111111111111111111111
1000000000C00000000000001
1011111111111111111111101
101P000010000000000001101
1010000001000000000011101
1010000010001000000000101
10100000000C0000000000101
1010000001100000000000101
1010000C001000C1000000101
1010000000000000000011101
1010000001001000000000001
1011111111111111111101111
10000000000000000000000E1
1111111111111111111111111