111111111111
1P111000C111
111E000CCCC1
111111111111