1111111111111
1P00010000001
100C00010E001
1110000000001
1C11111111111
1111111111111