1111111111
10P00C1111
1000E11111
11111111111111111