11111111111111111111
1P100000000000000001
11000000000000000001
10000000000000000001
10000000C00000000001
10000000000000000001
100000000000000000E1
11111111111111111111