11111111111111111111
0P000000000000000000
00000000000000000000
000000000C0000000000
000000000000000000E0
11111111111111111111